Map {
    width:50
    height:19
    world:02
}

Tiles {
00 00 00 00 00 00 00 00 00 00  00 00 00 00 00 00 00 00 00 00  00 00 00 00 00 00 00 00 00 00  00 00 00 00 00 00 00 00 00 00  00 00 00 00 00 00 00 00 00 00
00 00 00 00 00 00 00 00 00 00  00 00 00 00 00 00 00 00 00 00  00 00 00 00 00 00 00 00 00 00  00 00 00 00 00 00 00 00 00 00  00 00 00 00 00 00 00 00 00 00
00 00 00 00 00 00 00 00 00 00  00 00 00 00 00 00 00 00 00 00  00 00 00 00 00 00 00 00 00 00  00 00 00 00 00 00 00 00 00 00  00 00 00 00 00 00 00 00 00 00
00 00 00 00 00 00 00 00 00 00  00 00 00 00 00 00 00 00 00 00  00 00 00 00 00 00 00 00 00 00  00 00 00 00 00 00 00 00 00 00  00 00 00 00 00 00 00 00 00 00
00 00 00 00 00 00 00 00 00 00  00 00 00 00 00 00 00 00 00 00  00 00 00 00 00 00 00 00 00 00  00 00 00 00 00 00 00 00 00 00  00 00 00 00 00 00 00 00 00 00
00 00 00 00 00 00 00 00 00 00  00 00 00 00 00 00 00 00 00 00  00 00 00 00 00 00 00 00 00 00  00 00 00 00 00 00 00 00 00 00  00 00 00 00 00 00 00 00 00 00
00 00 00 00 00 00 00 00 00 00  00 00 00 00 00 00 00 00 00 00  00 00 00 00 00 00 00 00 00 00  00 00 00 00 00 00 00 00 00 00  00 00 00 00 00 00 00 00 00 00
00 00 00 00 00 00 00 00 00 00  00 00 00 00 00 00 00 00 00 00  00 00 00 00 00 00 00 00 00 00  00 00 00 00 00 00 00 00 00 00  00 00 00 00 00 00 00 00 00 00
00 00 00 00 00 00 00 00 00 00  00 00 00 00 00 00 00 00 00 00  00 00 00 00 00 00 00 00 00 00  00 00 00 00 00 00 00 00 00 00  00 00 00 00 00 00 00 00 00 00
00 00 00 00 00 00 00 00 00 00  00 00 00 00 00 00 00 00 00 00  00 00 02 00 00 00 00 00 00 00  00 00 00 00 00 00 00 00 00 00  00 00 00 00 00 00 00 00 00 00
00 00 00 00 00 00 00 00 00 00  00 00 00 00 00 00 00 00 00 00  00 00 00 00 00 00 00 00 00 00  00 00 00 00 00 00 00 00 00 00  00 00 00 00 00 00 00 00 00 00
00 00 00 00 00 00 00 00 00 00  00 00 00 00 00 00 00 00 00 00  00 00 00 00 00 00 00 00 00 00  00 00 00 00 00 00 00 00 00 00  00 00 00 00 00 00 00 00 00 00
00 00 00 00 00 00 00 00 00 00  00 00 00 00 00 00 00 00 00 00  00 00 00 00 00 00 00 00 00 00  00 00 00 00 00 00 00 00 00 00  00 00 00 00 00 00 00 00 00 00
00 00 00 00 00 00 00 00 00 00  00 00 00 00 00 00 02 00 00 00  01 02 01 02 01 00 00 00 00 00  00 00 00 00 00 00 00 00 00 00  00 00 00 00 00 00 04 06 00 00
00 00 00 00 00 00 00 00 00 00  00 00 00 00 00 00 00 00 00 00  00 00 00 00 00 00 00 00 00 00  00 00 00 00 00 00 00 00 04 06  00 00 00 00 00 00 01 01 00 00
00 00 00 00 00 00 00 00 00 00  00 00 00 00 00 00 00 00 00 00  00 00 00 00 00 00 00 00 04 06  00 00 00 00 00 00 00 00 01 01  00 00 00 00 00 00 01 01 00 00
06 00 00 00 00 00 00 00 00 00  00 00 00 00 00 00 00 00 00 00  00 00 00 00 00 00 00 00 01 01  00 00 00 00 00 00 00 00 01 01  00 00 00 00 00 00 01 01 00 00
09 05 05 05 05 05 05 05 05 05  05 05 05 05 05 05 05 05 05 05  05 05 05 05 05 05 05 05 08 09  05 05 05 05 05 05 05 05 08 09  05 05 05 05 05 05 08 09 05 05
01 01 01 01 01 01 01 01 01 01  01 01 01 01 01 01 01 01 01 01  01 01 01 01 01 01 01 01 01 01  01 01 01 01 01 01 01 01 01 01  01 01 01 01 01 01 01 01 01 01
}

Player {
    x:2
    y:2
    hero:1
}
Krawler {
    x:15
    y:3
    dir:left
}