10 6 01
00 00 00 00 00 00 00 00 00 00
00 FF 00 00 14 12 13 00 00 00
02 05 00 00 00 00 00 00 00 00
01 06 05 00 00 00 00 00 04 02
01 01 06 02 02 03 00 00 01 01
01 01 01 01 01 01 02 02 01 01