10 11 07
00 00 00 00 00 00 00 00 00 00
00 14 12 13 00 00 00 00 00 00
00 00 00 00 00 00 00 00 00 00
00 00 00 00 00 00 00 00 00 00
00 00 00 00 00 00 00 00 00 00
00 00 00 00 00 FF 00 00 00 00
00 00 00 00 14 12 13 00 00 00
02 03 00 00 00 00 00 00 00 00
01 01 03 00 00 00 00 00 04 02
01 01 01 02 02 03 00 00 01 01
01 01 01 01 01 01 02 02 01 01