30 7 01
00 00 00 00 00 00 00 00 00 00 00 00 00 00 00 00 00 00 00 00 00 00 00 00 00 00 00 07
07 00 00 00 00 00 00 00 00 00 00 00 00 00 00 00 00 00 00 00 00 00 00 00 00 00 00 01
01 00 00 00 00 00 00 00 00 00 00 07 00 00 00 00 00 00 00 00 00 00 00 00 00 00 00 01
01 00 00 00 FF 00 00 00 00 00 04 08 00 00 00 00 04 05 05 05 06 00 00 00 00 00 00 01
01 00 00 00 00 00 00 04 05 05 08 09 06 00 00 00 01 01 01 01 01 00 00 00 00 00 00 01
09 05 05 05 05 05 05 08 01 01 01 01 01 00 00 00 01 01 01 01 01 00 00 00 00 00 00 01
01 01 01 01 01 01 01 01 01 01 01 01 09 05 05 05 08 01 01 01 09 05 05 05 05 05 05 08