Map {
    width:173
    height:19
    world:02
}

Tiles {
00 00 00 00 00 00 00 00 00 00  00 00 00 00 00 00 00 00 00 00  00 00 00 00 00 00 00 00 00 00  00 00 00 00 00 00 00 00 00 00  00 00 00 00 00 00 00 00 00 00  00 00 00 00 00 00 00 00 00 00  00 00 00 00 00 00 00 00 00 00  00 00 00 00 00 00 00 00 00 00  00 00 00 00 00 00 00 00 00 00  00 00 00 00 00 00 00 00 00 00  00 00 00 00 00 00 00 00 00 00  00 00 00 00 00 00 00 00 00 00  00 00 00 00 00 00 00 00 00 00  00 00 00 00 00 00 00 00 00 00  00 00 00 00 00 00 00 00 00 00  00 00 00 00 00 00 00 00 00 00  00 00 00 00 00 00 00 00 00 00  00 00
00 00 00 00 00 00 00 00 00 00  00 00 00 00 00 00 00 00 00 00  00 00 00 00 00 00 00 00 00 00  00 00 00 00 00 00 00 00 00 00  00 00 00 00 00 00 00 00 00 00  00 00 00 00 00 00 00 00 00 00  00 00 00 00 00 00 00 00 00 00  00 00 00 00 00 00 00 00 00 00  00 00 00 00 00 00 00 00 00 00  00 00 00 00 00 00 00 00 00 00  00 00 00 00 00 00 00 00 00 00  00 00 00 00 00 00 00 00 00 00  00 00 00 00 00 00 00 00 00 00  00 00 00 00 00 00 00 00 00 00  00 00 00 00 00 00 00 00 00 00  00 00 00 00 00 00 00 00 00 00  00 00 00 00 00 00 00 00 00 00  00 00
00 00 00 00 00 00 00 00 00 00  00 00 00 00 00 00 00 00 00 00  00 00 00 00 00 00 00 00 00 00  00 00 00 00 00 00 00 00 00 00  00 00 00 00 00 00 00 00 00 00  00 00 00 00 00 00 00 00 00 00  00 00 00 00 00 00 00 00 00 00  00 00 00 00 00 00 00 00 00 00  00 00 00 00 00 00 00 00 00 00  00 00 00 00 00 00 00 00 00 00  00 00 00 00 00 00 00 00 00 00  00 00 00 00 00 00 00 00 00 00  00 00 00 00 00 00 00 00 00 00  00 00 00 00 00 00 00 00 00 00  00 00 00 00 00 00 00 00 00 00  00 00 00 00 00 00 00 00 00 00  00 00 00 00 00 00 00 00 00 00  00 00
00 00 00 00 00 00 00 00 00 00  00 00 00 00 00 00 00 00 00 00  00 00 00 00 00 00 00 00 00 00  00 00 00 00 00 00 00 00 00 00  00 00 00 00 00 00 00 00 00 00  00 00 00 00 00 00 00 00 00 00  00 00 00 00 00 00 00 00 00 00  00 00 00 00 00 00 00 00 00 00  00 00 00 00 00 00 00 00 00 00  00 00 00 00 00 00 00 00 00 00  00 00 00 00 00 00 00 00 00 00  00 00 00 00 00 00 00 00 00 00  00 00 00 00 00 00 00 00 00 00  00 00 00 00 00 00 00 00 00 00  00 00 00 00 00 00 00 00 00 00  00 00 00 00 00 00 00 00 00 00  00 00 00 00 00 00 00 00 00 00  00 00
00 00 00 00 00 00 00 00 00 00  00 00 00 00 00 00 00 00 00 00  00 00 00 00 00 00 00 00 00 00  00 00 00 00 00 00 00 00 00 00  00 00 00 00 00 00 00 00 00 00  00 00 00 00 00 00 00 00 00 00  00 00 00 00 00 00 00 00 00 00  00 00 00 00 00 00 00 00 00 00  00 00 00 00 00 00 00 00 00 00  00 00 00 00 00 00 00 00 00 00  00 00 00 00 00 00 00 00 00 00  00 00 00 00 00 00 00 00 00 00  00 00 00 00 00 00 00 00 00 00  00 00 00 00 00 00 00 00 00 00  00 00 00 00 00 00 00 00 00 00  00 00 00 00 00 00 00 00 00 00  00 00 00 00 00 00 00 00 00 00  00 00
00 00 00 00 00 00 00 00 00 00  00 00 00 00 00 00 00 00 00 00  00 00 00 00 00 00 00 00 00 00  00 00 00 00 00 00 00 00 00 00  00 00 00 00 00 00 00 00 00 00  00 00 00 00 00 00 00 00 00 00  00 00 00 00 00 00 00 00 00 00  00 00 00 00 00 00 00 00 00 00  00 00 00 00 00 00 00 00 00 00  00 00 00 00 00 00 00 00 00 00  00 00 00 00 00 00 00 00 00 00  00 00 00 00 00 00 00 00 00 00  00 00 00 00 00 00 00 00 00 00  00 00 00 00 00 00 00 00 00 00  00 00 00 00 00 00 00 00 00 00  00 00 00 00 00 00 00 00 00 00  00 00 00 00 00 00 00 00 00 00  00 00
00 00 00 00 00 00 00 00 00 00  00 00 00 00 00 00 00 00 00 00  00 00 00 00 00 00 00 00 00 00  00 00 00 00 00 00 00 00 00 00  00 00 00 00 00 00 00 00 00 00  00 00 00 00 00 00 00 00 00 00  00 00 00 00 00 00 00 00 00 00  00 00 00 00 00 00 00 00 00 00  00 00 00 00 00 00 00 00 00 00  00 00 00 00 00 00 00 00 00 00  00 00 00 00 00 00 00 00 00 00  00 00 00 00 00 00 00 00 00 00  00 00 00 00 00 00 00 00 00 00  00 00 00 00 00 00 00 00 00 00  00 00 00 00 00 00 00 00 00 00  00 00 00 00 00 00 00 00 00 00  00 00 00 00 00 00 00 00 00 00  00 00
00 00 00 00 00 00 00 00 00 00  00 00 00 00 00 00 00 00 00 00  00 00 00 00 00 00 00 00 00 00  00 00 00 00 00 00 00 00 00 00  00 00 00 00 00 00 00 00 00 00  00 00 00 00 00 00 00 00 00 00  00 00 00 00 00 00 00 00 00 00  00 00 00 00 00 00 00 00 00 00  00 00 00 00 00 00 00 00 00 00  00 00 00 00 00 00 00 00 00 00  00 00 00 00 00 00 00 00 00 00  00 00 00 00 00 00 00 00 00 00  00 00 00 00 00 00 00 00 00 00  00 00 00 00 00 00 00 00 00 00  00 00 00 00 00 00 00 00 00 00  00 00 00 00 00 00 00 00 00 00  00 00 00 00 00 00 00 00 00 00  00 00
00 00 00 00 00 00 00 00 00 00  00 00 00 00 00 00 00 00 00 00  00 00 00 00 00 00 00 00 00 00  00 00 00 00 00 00 00 00 00 00  00 00 00 00 00 00 00 00 00 00  00 00 00 00 00 00 00 00 00 00  00 00 00 00 00 00 00 00 00 00  00 00 00 00 00 00 00 00 00 00  00 00 00 00 00 00 00 00 00 00  00 00 00 00 00 00 00 00 00 00  00 00 00 00 00 00 00 00 00 00  00 00 00 00 00 00 00 00 00 00  00 00 00 00 00 00 00 00 00 00  00 00 00 00 00 00 00 00 00 00  00 00 00 00 00 00 00 00 00 00  00 00 00 00 00 00 00 00 00 00  00 00 00 00 00 00 00 00 00 00  00 00
00 00 00 00 00 00 00 00 00 00  00 00 00 00 00 00 00 00 00 00  00 00 02 00 00 00 00 00 00 00  00 00 00 00 00 00 00 00 00 00  00 00 00 00 00 00 00 00 00 00  00 00 00 00 00 00 00 00 00 00  00 00 00 00 00 00 00 00 00 04  05 05 05 05 05 05 06 00 00 00  04 05 05 06 00 00 00 00 00 00  00 00 00 00 00 00 00 00 07 00  00 00 00 00 00 00 00 00 00 00  04 05 05 06 00 00 00 00 00 00  00 00 00 00 00 00 00 00 00 00  00 00 00 00 00 00 00 00 00 00  00 00 00 00 00 00 00 00 00 00  00 00 00 00 00 00 00 00 00 00  00 00 00 00 00 00 00 00 00 00  04 06
00 00 00 00 00 00 00 00 00 00  00 00 00 00 00 00 00 00 00 00  00 00 00 00 00 00 00 00 00 00  00 00 00 00 00 00 00 00 00 00  00 00 00 00 00 00 00 00 00 00  00 00 00 00 00 00 00 00 00 00  00 00 00 00 00 00 00 00 00 00  00 00 00 00 00 00 00 00 00 00  00 00 00 00 00 00 00 00 00 00  00 00 00 00 00 00 00 00 00 00  00 00 00 00 00 00 00 00 00 00  00 00 00 00 00 00 00 00 00 00  00 00 00 00 00 00 00 00 00 00  00 00 00 00 00 00 00 00 00 00  00 00 00 00 00 00 00 00 00 00  00 00 00 00 00 00 00 00 00 00  00 00 00 00 00 00 00 00 00 04  08 01
00 00 00 00 00 00 00 00 00 00  00 00 00 00 00 00 00 00 00 00  00 00 00 00 00 00 00 00 00 00  00 00 00 00 00 00 00 00 00 00  00 00 00 00 00 00 00 00 00 00  00 00 00 00 00 00 00 00 00 00  00 00 00 00 00 00 00 00 00 00  00 00 00 00 00 00 00 00 00 00  00 00 00 00 00 00 00 00 00 00  00 00 00 00 00 00 00 00 00 00  00 00 00 00 00 00 00 00 00 00  00 00 00 00 00 00 00 00 00 00  00 00 00 00 00 00 00 00 00 00  00 00 00 00 00 00 00 00 00 00  00 00 00 00 00 00 00 00 00 00  00 00 00 00 00 00 00 00 00 00  00 00 00 00 00 00 00 00 04 08  01 01
00 00 00 00 00 00 00 00 00 00  00 00 00 00 00 00 00 00 00 00  00 00 00 00 00 00 00 00 00 00  00 00 00 00 00 00 00 00 00 00  00 00 00 00 00 00 00 00 00 00  00 00 00 07 00 00 00 00 00 00  00 00 00 00 00 00 00 00 00 00  00 00 00 00 00 00 00 00 00 00  00 00 00 00 00 00 00 00 00 00  00 00 00 00 00 00 00 00 00 00  00 00 00 00 00 00 00 00 00 00  00 00 00 00 00 00 00 00 00 00  00 00 00 00 00 00 00 00 00 00  00 00 00 00 00 00 00 00 00 00  00 00 00 00 00 00 00 00 00 00  00 00 00 00 00 00 00 00 00 00  00 00 00 00 00 00 00 04 08 01  01 01
00 00 00 00 00 00 00 00 00 00  00 00 00 00 00 00 02 00 00 00  01 02 01 02 01 00 00 00 00 00  00 00 00 00 00 00 00 00 00 00  00 00 00 00 00 00 04 06 00 00  00 00 00 00 00 00 00 00 00 00  00 00 00 00 00 00 04 05 06 00  00 00 00 00 00 00 00 00 00 00  00 00 00 07 00 00 00 00 00 04  06 00 00 00 00 07 00 00 07 00  00 07 00 00 00 00 00 07 00 00  00 04 06 00 00 00 00 00 00 07  00 00 07 00 00 00 00 00 00 00  00 00 00 04 06 00 00 07 00 00  00 00 00 00 00 00 00 00 00 00  04 05 05 06 00 00 00 00 00 00  00 00 00 00 00 00 04 08 01 01  01 01
00 00 00 00 00 00 00 00 00 00  00 00 00 00 00 00 00 00 00 00  00 00 00 00 00 00 00 00 00 00  00 00 00 00 00 00 00 00 04 06  00 00 00 00 00 00 01 01 00 00  00 00 00 00 00 00 00 00 00 00  00 00 00 00 00 00 00 00 00 00  00 00 00 00 00 00 00 00 00 00  00 00 00 00 00 00 00 00 00 00  00 00 00 00 00 00 00 00 00 00  00 00 00 00 00 00 00 00 00 00  00 00 00 00 00 00 00 00 04 08  00 00 09 06 00 00 00 00 00 00  00 00 04 08 01 00 00 09 06 00  00 00 00 00 00 00 00 00 00 00  00 00 00 00 00 00 00 00 00 00  00 00 00 00 00 04 08 01 01 01  01 01
00 00 00 00 00 00 00 00 00 00  00 00 00 00 00 00 00 00 00 00  00 00 00 00 00 00 00 00 04 06  00 00 00 00 00 00 00 00 01 01  00 00 00 00 00 00 01 01 00 00  00 00 00 00 00 00 00 00 00 00  00 00 00 00 00 00 00 00 00 00  00 00 00 00 00 00 00 00 00 00  00 00 00 00 00 00 00 00 00 00  00 00 00 00 00 00 00 00 00 00  00 00 00 00 00 00 00 00 00 00  00 00 00 00 00 00 00 04 08 01  00 00 01 09 06 00 00 00 00 00  00 04 08 01 01 00 00 01 09 06  00 00 00 00 00 04 06 00 00 00  00 00 00 00 00 00 00 00 00 00  00 04 06 00 04 08 01 01 01 01  01 01
06 00 00 00 00 00 00 00 00 00  00 00 00 00 00 00 00 00 00 00  00 00 00 00 00 00 00 00 01 01  00 00 00 00 00 00 00 00 01 01  00 00 00 00 00 00 01 01 00 00  00 00 00 00 00 00 00 00 00 00  00 00 00 00 00 00 00 00 00 00  00 00 00 00 00 00 00 00 00 00  00 00 00 00 00 00 00 00 00 00  00 00 00 00 00 00 00 00 00 00  00 00 00 00 00 00 00 00 00 00  00 00 00 00 00 00 04 08 01 01  00 00 01 01 09 06 00 00 00 00  04 08 01 01 01 00 00 01 01 09  06 00 00 00 00 01 01 00 00 00  00 00 00 00 00 00 00 00 00 00  00 01 09 05 08 01 01 01 01 01  01 01
09 05 05 05 05 05 05 05 05 05  05 05 05 05 05 05 05 05 05 05  05 05 05 05 05 05 05 05 08 09  05 05 05 05 05 05 05 05 08 09  05 05 05 05 05 05 08 09 05 05  05 05 05 05 05 05 05 06 00 00  04 05 05 05 05 05 05 05 05 05  05 05 05 05 06 00 00 00 04 05  05 05 05 05 05 05 05 05 05 05  05 05 05 05 05 05 05 05 05 05  05 05 05 05 05 05 05 05 05 05  05 05 05 05 05 05 08 01 01 09  05 05 08 01 01 09 05 05 05 05  08 01 01 01 01 00 00 01 01 01  09 05 05 05 05 08 09 05 05 05  05 05 05 05 05 05 05 05 05 05  05 08 01 01 01 01 01 01 01 01  01 01
01 01 01 01 01 01 01 01 01 01  01 01 01 01 01 01 01 01 01 01  01 01 01 01 01 01 01 01 01 01  01 01 01 01 01 01 01 01 01 01  01 01 01 01 01 01 01 01 01 01  01 01 01 01 01 01 01 01 00 00  01 01 01 01 01 01 01 01 01 01  01 01 01 01 01 00 00 00 01 01  01 01 01 01 01 01 01 01 01 01  01 01 01 01 01 01 01 01 01 01  01 01 01 01 01 01 01 01 01 01  01 01 01 01 01 01 01 01 01 01  01 01 01 01 01 01 01 01 01 01  01 01 01 01 01 00 00 01 01 01  01 01 01 01 01 01 01 01 01 01  01 01 01 01 01 01 01 01 01 01  01 01 01 01 01 01 01 01 01 01  01 01
}

Player {
    x:3
    y:3
    hero:1
}
Krawler {
    x:15
    y:3
    dir:left
}