30 19 02
00 00 00 00 00 00 00 00 00 00  00 00 00 00 00 00 00 00 00 00  00 00 00 00 00 00 00 00 00 00
00 00 00 00 00 00 00 00 00 00  00 00 00 00 00 00 00 00 00 00  00 00 00 00 00 00 00 00 00 00
00 00 00 00 00 00 00 00 00 00  00 00 00 00 00 00 00 00 00 00  00 00 00 00 00 00 00 00 00 00
00 00 00 00 00 00 00 00 00 00  00 00 00 00 00 00 00 00 00 00  00 00 00 00 00 00 00 00 00 00
00 00 00 00 00 00 00 00 00 00  00 00 00 00 00 00 00 00 00 00  00 00 00 00 00 00 00 00 00 00
00 00 00 00 00 00 00 00 00 00  00 00 00 00 00 00 00 00 00 00  00 00 00 00 00 00 00 00 00 00
00 00 00 00 00 00 00 00 00 00  00 00 00 00 00 00 00 00 00 00  00 00 00 00 00 00 00 00 00 00
00 00 00 00 00 00 00 00 00 00  00 00 00 00 00 00 00 00 00 00  00 00 00 00 00 00 00 00 00 00
00 00 00 00 00 00 00 00 00 00  00 00 00 00 00 00 00 00 00 00  00 00 00 00 00 00 00 00 00 00
00 00 00 00 00 00 00 00 00 00  00 00 00 00 00 00 00 00 00 00  00 00 02 00 00 00 00 00 00 00
00 00 00 00 00 00 00 00 00 00  00 00 00 00 00 00 00 00 00 00  00 00 00 00 00 00 00 00 00 00
00 00 00 00 00 00 00 00 00 00  00 00 00 00 00 00 00 00 00 00  00 00 00 00 00 00 00 00 00 00
00 00 00 00 00 00 00 00 00 00  00 00 00 00 00 00 00 00 00 00  00 00 00 00 00 00 00 00 00 00
00 00 00 00 00 00 00 00 00 00  00 00 00 00 00 00 00 00 00 00  01 02 01 02 01 00 00 00 00 00
00 00 00 00 00 00 00 00 00 00  00 00 00 00 00 00 02 00 00 00  00 00 00 00 00 00 00 00 00 00
00 00 00 00 00 00 00 00 00 00  00 00 00 00 00 00 00 00 00 00  00 00 00 00 00 00 00 00 00 00
00 00 FF 00 00 00 00 00 00 00  00 00 00 00 00 00 00 00 00 00  00 00 00 00 00 00 00 00 00 00
05 05 05 05 05 05 05 05 05 05  05 05 05 05 05 05 05 05 05 05  05 05 05 05 05 05 05 05 05 05
01 01 01 01 01 01 01 01 01 01  01 01 01 01 01 01 01 01 01 01  01 01 01 01 01 01 01 01 01 01